2 1 16 2 1 16 1 1 3 15 1 6 16
2 0 0 0 0 0 0 0 0 0 0 0 13
2 0 0 0 0 0 0 0 0 0 0 0 1
2 0 0 0 0 0 0 0 0 0 0 0 16
2 0 0 0 0 0 0 0 0 0 0 0 1
2 0 0 0 0 0 0 0 0 0 0 0 1
2 0 0 0 0 0 0 0 0 0 0 0 16
2 0 0 0 0 0 0 0 0 0 0 0 1
2 0 0 0 0 0 0 0 0 0 0 0 16
2 0 0 0 0 0 0 0 0 0 0 0 1
2 0 0 0 0 0 0 0 0 0 0 0 13
2 0 0 0 0 0 0 0 0 0 0 0 1
13 10 10 10 10 10 10 10 10 10 10 10 10 10